ABORT	AH B AO R T
AHEAD	AH HH EH D
BACK	B AE K
BACKWARD	B AE K W ER D
BEGIN	B IH G IH N
CLOSE	K L OW S
CLOSE(2)	K L OW Z
EXIT	EH G Z IH T
EXIT(2)	EH K S AH T
FAST	F AE S T
FASTER	F AE S T ER
FORWARD	F AO R W ER D
GO	G OW
GRASP	G R AE S P
GRIP	G R IH P
HALT	HH AO L T
LEFT	L EH F T
LOOK	L UH K
MOVE	M UW V
OFF	AO F
OPEN	OW P AH N
RIGHT	R AY T
ROBO	R OW B OW
RUN	R AH N
SLOW	S L OW
SLOWER	S L OW ER
SPIN	S P IH N
START	S T AA R T
STOP	S T AA P
STRAIGHT	S T R EY T
TURN	T ER N
TWIST	T W IH S T
